{
  "gameObjects" : [
    [ 1, 1, 1, 1, 1, 1, 1, 1, 1, 1, 1, 0, 0, 0, 0, 0, 0, 0, 0, 0, 0, 0, 0, 0],
    [ 1, 0, 0, 0, 0, 0, 0, 2, 0, 0, 1, 1, 1, 1, 1, 1, 0, 0, 0, 0, 0, 0, 0, 0],
    [ 1, 0, 0, 0, 0, 0, 0, 2, 0, 0, 1, 0, 0, 0, 0, 1, 0, 0, 0, 0, 0, 0, 0, 0],
    [ 1, 0, 3, 3, 3, 0, 0, 3, 0, 0, 0, 0, 0, 0, 0, 1, 1, 1, 1, 1, 1, 1, 0, 0],
    [ 1, 0, 0, 3, 0, 0, 0, 0, 3, 0, 1, 0, 2, 3, 0, 2, 0, 0, 0, 0, 0, 1, 0, 0],
    [ 1, 0, 0, 0, 0, 0, 0, 0, 3, 0, 1, 0, 2, 2, 0, 2, 0, 0, 2, 2, 0, 1, 0, 0],
    [ 1, 0, 0, 0, 0, 3, 3, 0, 1, 1, 1, 0, 0, 0, 0, 1, 0, 0, 2, 3, 0, 1, 1, 1],
    [ 1, 0, 0, 0, 3, 3, 3, 0, 1, 0, 0, 0, 0, 0, 0, 1, 0, 0, 0, 0, 0, 0, 0, 1],
    [ 1, 0, 1, 0, 3, 3, 0, 0, 1, 0, 0, 0, 0, 1, 0, 1, 0, 0, 0, 1, 3, 0, 0, 1],
    [ 1, 0, 0, 0, 0, 0, 0, 0, 2, 0, 0, 0, 0, 0, 0, 1, 0, 0, 0, 3, 2, 0, 0, 1],
    [ 1, 0, 0, 0, 0, 0, 0, 0, 2, 0, 0, 0, 0, 0, 0, 1, 0, 0, 0, 0, 0, 0, 0, 1],
    [ 1, 1, 1, 1, 1, 1, 1, 1, 1, 0, 0, 0, 1, 1, 1, 1, 1, 1, 2, 2, 2, 1, 1, 1],
    [ 0, 0, 0, 0, 0, 0, 0, 0, 1, 0, 0, 0, 0, 0, 0, 0, 0, 0, 0, 0, 0, 1, 0, 0],
    [ 0, 0, 0, 0, 0, 0, 0, 0, 1, 0, 0, 0, 0, 0, 0, 3, 3, 3, 0, 0, 0, 1, 0, 0],
    [ 0, 0, 0, 0, 0, 0, 0, 0, 1, 0, 0, 0, 0, 0, 0, 3, 3, 3, 0, 1, 1, 1, 0, 0],
    [ 0, 0, 0, 0, 0, 0, 0, 0, 1, 0, 0, 0, 0, 0, 0, 0, 0, 0, 0, 1, 0, 0, 0, 0],
    [ 0, 0, 0, 0, 0, 0, 0, 0, 1, 1, 1, 1, 1, 1, 1, 1, 1, 1, 1, 1, 0, 0, 0, 0]
  ],
  "enemies": [
    {
      "x": 286,
      "y": 88,
      "healthPercentage": 1
    },
    {
      "x": 368,
      "y": 90,
      "healthPercentage": 0.5
    },
    {
      "x": 668,
      "y": 250,
      "healthPercentage": 0.8
    },
    {
      "x": 568,
      "y": 220,
      "healthPercentage": 0.3
    },
    {
      "x": 540,
      "y": 220,
      "healthPercentage": 0.3
    }
  ]
}
